###################################################
#S#   #   #           # #       #       #     #   #
# # # # # # ######### # # ### # # ### # # # # ### #
# # # # # #   #     # # # #   # # #   # # # #     #
# # # # # ### # ### # # # # ##### # ### # # ##### #
#   #   # #   #   #   # # #       # # # # # #     #
######### # ##### ##### # ##### ### # # # # ##### #
#       #   #   #     #   #   # #   #   # #     # #
# # ######### ####### ##### # ### ### ### ##### # #
# # #       #       #   #   #     #   #   #   # # #
# # # ##### # ##### ### # ######### ####### # # # #
# #   #   # # # #     #   #       # #       #   # #
# ##### ### # # # ######### ### ### ### ######### #
#   #     #   # # #   #     #   #   #   # #       #
### ##### ##### # # # # ##### ### ### ### # #######
#               #   #       #         #          E#
###################################################
